1111111111111111111111111
1N1N1N1N111111111N1N1N1N1
11111111CCCCCCCCC11111111
1PCCCCCCCCCCCCCCCCCCCCCE1
11111111CCCCCCCCC11111111
1N1N1N1N111111111N1N1N1N1
1111111111111111111111111
