1111111111111111111111111111111111
1E000N000000000C00000C000000000001
101001010010000010100100N000010101
1010010010101010001001000000010101
1P000N000C00C000N00000000N000000C1
1111111111111111111111111111111111
