11111111
100EC001
1C01N0P1
11111111
