1111111111111111111111111111111111
1E0000000000000C00000C000000000001
1010010100100000101001000000010101
101001001010101000100100N00001011
1P0000000C00C00000000N0000000N00C1
1111111111111111111111111111111111
