11111111
100EC001
1C0100P1
11111111
