1111111111111111111111111111111111
1000100010001000100010001000100011
1010101010101010101010101010101011
1010101010101010101010101010101011
1P10001000100010001C001000100010E1
1111111111111111111111111111111111
